%%%%%%%%%%%%%%%%%%%%
%                  %
%                  %
%                  %
%                  %
%                  %
%                  %
%    % %           %
%%%%%  %%%         %
%      %           %
%      %%%         %
%      %           %
%      %           %
%      %           %
%%%%%% %           %
%.     %          P%
%%%%%%%%%%%%%%%%%%%%